border_size=1
usage=map

Wo          , Ww          , Ww          , Ww          , Wwf         , Ds          , Ds          , Ds          , Ds          , Gs          , Gs          , Gs^Ft       , Gd          , Gd          , Hhd         , Gd          , Gd          , Gll^Fmf     , Gll^Fmf     , Gd          , Gd          , Gd          , Gd          , Gd          , Gd          , Gd          , Gd          , Gd          , Gs          , Gs          , Hh          , Mm          , Mm          , Mm          , Mm          , Hh          , Hh          , Re          , Gs          , Hh          , Hh          , Mm          , Mm^Xm       , Mm^Xm       , Mm^Xm       , Mm^Xm       
Wo          , Ww          , Ww          , Ww          , Ww          , Ds          , Ds          , Dd          , Ds          , Gs          , Gs^Ft       , Gd          , Gd          , Gd          , Gd          , Gd          , Gd          , Gd          , Gd          , Gd          , Gd          , Gd          , Gd          , Gd          , Gd          , Gd          , Gd          , Gd          , Gs          , Gs          , Gs          , Hh          , Hh          , Mm          , Mm          , Mm          , Hh          , Re          , Hh          , Hh          , Mm          , Mm          , Mm          , Mm^Xm       , Mm^Xm       , Mm^Xm       
Wo          , Ww          , Wwr         , Ww          , Ww          , Ds          , Ds          , Ds          , Ds          , Gs          , Gs          , Gd          , Gd          , Gd          , Gd          , Gd          , Ce          , Gd          , Gd          , Gd          , Hhd         , Gd          , Gd          , Gd          , Gd          , Gd          , Gll^Fp      , Gd          , Gd          , Gs          , Gs          , Gs          , Gs          , Gs          , Gs          , Hh          , Gs          , Re          , Hh          , Mm          , Mm          , Mm          , Mm          , Mm          , Mm          , Mm          
Wo          , Ww          , Ww          , Ww          , Ww          , Dd          , Dd          , Ds          , Ds          , Dd          , Gs          , Gs          , Hh          , Hhd         , Hhd         , Ce          , 3 Ke        , Ce          , Gd          , Gd          , Hhd         , Md          , Hhd         , Gd          , Gll^Fp      , Gll^Fmf     , Gd^Fdf      , Gll^Fp      , Gd          , Gll^Fp      , Gg^Ve       , Gll^Fp      , Hh          , Hh          , Hh          , Gs          , Gs          , Re          , Re          , Hh          , Hh          , Mm          , Mm          , Mm          , Mm          , Mm          
Ww          , Ww          , Ww          , Ww          , Ww          , Dd          , Dd          , Ds          , Ds          , Dd          , Gs^Ft       , Gs          , Hh          , Md          , Re          , Ce          , Ce          , Ce          , Gd          , Gd          , Hhd^Vhhr    , Md          , Hhd         , Gd          , Gll^Fmf     , Gll^Fmf     , Gd^Fdf      , Gd^Fdf      , Gll^Fmf     , Gd          , Gd^Fmw      , Gs          , Gs          , Hh          , Hh          , Gs          , Gs          , Gs          , Re          , Gs          , Gs          , Hh          , Hh          , Mm          , Mm          , Mm          
Wo          , Ww          , Wwr         , Ww          , Wwr         , Wwf         , Dd          , Dd          , Ds          , Ds          , Gs          , Gs^Ft       , Gs          , Hh^Vhh      , Re          , Re          , Re          , Re          , Gd          , Hhd         , Gd          , Hhd         , Gd          , Gll^Fmf     , Gll^Fmf     , Gd^Fdf      , Gd^Fdf      , Gd^Fdf      , Gll^Fmf     , Gll^Fp      , Gll^Fmf     , Gs          , Gs          , Hh          , Gs          , Gs          , Gs          , Gs          , Re          , Gs          , Gs          , Hh          , Hh          , Mm          , Mm          , Mm          
Wo          , Ww          , Ww          , Wwr         , Ww          , Ww          , Ds          , Ds          , Ss          , Ss          , Gs          , Gs          , Gs          , Gd          , Gd          , Re          , Gd          , Gd          , Hhd         , Gd          , Gd          , Gd          , Gll^Fmf     , Gll^Fmf     , Gd^Fdf      , Gll^Fp      , Gll^Fmf     , Gll^Fmf     , Gll^Fp      , Gll^Fmf     , Gd          , Gd          , Gd          , Gs          , Gs          , Gs          , Ww          , Ww          , Gs^Vc       , Re          , Hh          , Gs          , Gs          , Hh          , Hh          , Mm          
Wo          , Ww          , Ww          , Ww          , Ww          , Ww          , Ww          , Wwf         , Wwf         , Ss          , Gs          , Gs          , Gs^Ft       , Gs          , Ww          , Gd          , Gd          , Gd          , Gd          , Gd          , Gd          , Gll^Fp      , Gll^Fmf     , Gll^Fmf     , Gd^Fdf      , Gll^Fmf     , Gd          , Ss          , Gd          , Gd          , Gd          , Gd          , Gd          , Gd          , Gd          , Gs          , Gs          , Ww          , Gs          , Re          , Gs          , Gs          , Gs          , Hh          , Hh          , Hh          
Wo          , Wo          , Ww          , Ww          , Ww          , Ww          , Ww          , Ds          , Dd          , Ds          , Ds          , Gs          , Gs          , Ww          , Ww          , Ww          , Gd          , Gd          , Gd          , Gd          , Gd          , Gll^Fp      , Gll^Fmf     , Gll^Fp      , Gll^Fmf     , Gll^Fmf     , Gd          , Gd          , Gd          , Hhd         , Md          , Hhd         , Hhd         , Gd          , Md          , Hhd         , Gd          , Gs          , Gs          , Re          , Gs          , Gs          , Gs          , Gs          , Hh          , Hh          
Wo          , Ww          , Ww          , Ww          , Wwr         , Ww          , Ww          , Ds          , Dd          , Ds          , Ds          , Gs          , Ss          , Gs          , Gd          , Gd          , Gd          , Gd          , Gd          , Gd          , Gd          , Gd          , Gd^Vo       , Gd          , Gd          , Gd          , Gd          , Gd          , Gd          , Hhd         , Hhd         , Md          , Md          , Hhd         , Hhd         , Md          , Hhd         , Gd          , Gd          , Re          , Ce          , Ce          , Ce          , Gs          , Gs          , Gs          
Ww          , Ww          , Ww          , Ww          , Ww          , Ww          , Ww          , Ds          , Ds          , Ds          , Dd^Do       , Gs^Ft       , Gs^Ft       , Gs^Ft       , Gs^Ft       , Gd          , Gd          , Gd          , Gd          , Gd          , Gd          , Gd          , Gd          , Gd          , Gd          , Hhd         , Gd          , Gd          , Gd          , Gd          , Ss          , Md          , Md          , Md          , Md          , Md          , Md          , Hhd         , Gd          , Re          , Ce          , 1 Ke        , Ce          , Gd          , Gd          , Gs          
Ww          , Ww          , Ww          , Ww^Vm       , Ww          , Ww          , Ww          , Ds          , Ds          , Ds          , Dd          , Gs^Ft       , Gs^Ft       , Gs^Ft       , Gs^Ft       , Gs^Ft       , Re          , Re          , Re          , Gd          , Gd          , Gd          , Gd          , Gll^Fmf     , Gd          , Gd          , Gd          , Gd          , Ww          , Ss          , Ss          , Hhd         , Hhd         , Md          , Md          , Hhd         , Md^Xm       , Hhd         , Gd          , Re          , Hhd         , Ce          , Gd          , Gd          , Gd          , Gd          
Ww          , Ww          , Ww          , Ww          , Ww          , Ww          , Ww          , Wwf         , Ds          , Dd          , Dd          , Dd          , Gs^Ft       , Gs^Ft       , Gs^Ft       , Gd^Vhr      , Ce          , Re          , Re          , Gd^Fmw      , Gd^Fmw      , Gd          , Gd          , Gd          , Hhd         , Gd          , Gd          , Gd          , Ww          , Ww          , Wwf         , Wwf         , Gd          , Gd^Vh       , Md          , Md^Xm       , Md          , Md          , Md          , Re          , Md          , Hhd         , Hhd         , Gd          , Gd          , Gd          
Wo          , Ww          , Ww          , Ww          , Ww          , Ww          , Ww          , Wwf         , Ds          , Ds          , Ds          , Ds          , Gs          , Gs^Ft       , Gs^Ft       , Ce          , 2 Ke        , Ce          , Gd^Vo       , Hh          , Hh          , Hh          , Md          , Gd          , Hhd         , Hhd         , Gd          , Gd          , Wwf         , Wwf         , Wwf         , Wwf         , Gd          , Hhd         , Md          , Md^Xm       , Md^Xm       , Hhd         , Md          , Re          , Re          , Hhd         , Md          , Hhd         , Gd          , Gd          
Wo          , Wo          , Ww          , Wwr         , Ww          , Ww          , Ww          , Ww          , Ds          , Ds          , Ds          , Ds          , Gs^Ft       , Gs^Ft       , Gs^Ft       , Ce          , Ce          , Ce          , Hh          , Hh          , Mm          , Hh          , Hh          , Hhd^Fdw     , Hhd^Fdw     , Gd          , Gd          , Gd          , Gd          , Wwf         , Wwf         , Ww          , Gd          , Hhd         , Md          , Md          , Md          , Md^Xm       , Md          , Hhd         , Re          , Md          , Md^Xm       , Md          , Gd          , Gd          
Wo          , Wo          , Ww          , Ww          , Wwr         , Ww          , Ww          , Ww          , Ds          , Ds          , Dd          , Ds          , Ds          , Gs^Ft       , Gs^Ft       , Gs^Ft       , Gs          , Mm          , Hh^Fp       , Mm          , Mm          , Mm          , Hh          , Hh          , Gd          , Gd          , Gll^Fp      , Gll^Fmf     , Gll^Fp      , Gll^Fp      , Gll^Fp      , Gd          , Gd          , Gd          , Hhd         , Md          , Md          , Md          , Hhd         , Hhd         , Re          , Md          , Md          , Hhd         , Gd          , Gd          
Wo          , Wo          , Ww          , Ww          , Wwr         , Wwr         , Ww          , Ww          , Ww          , Ds          , Ds          , Ds          , Ds          , Gs          , Gs          , Gs          , Gs^Ft       , Hh          , Gs^Ft       , Hh          , Gs^Ft       , Hh          , Gs^Ft       , Hh          , Gs^Ft       , Gd          , Gll^Fmf     , Gll^Fmf     , Gll^Fp      , Gll^Fmf     , Gll^Fmf     , Gd          , Gd^Vh       , Gd          , Gd          , Hhd         , Hhd^Fmf     , Md          , Md          , Hhd         , Re          , Hhd^Vhh     , Hhd         , Gd          , Gd          , Gd          
Ww          , Ww          , Ww          , Ww          , Ww          , Wwr         , Wwr         , Ww          , Ww          , Ds          , Ds          , Ds          , Dd          , Ds          , Ds          , Gs          , Ds          , Gs          , Gs^Ft       , Gs^Ft       , Gs^Ft       , Gs^Ft       , Gs^Ft       , Gs          , Gs^Ft       , Gll^Fp      , Gd^Vhr      , Gll^Fmf     , Gll^Fmf     , Hhd^Fmf     , Gll^Fp      , Gd          , Gll^Fp      , Gd          , Gd          , Gll^Fmf     , Gll^Fmf     , Hhd^Fmf     , Hhd         , Hhd         , Re          , Md          , Hhd         , Gd          , Gd          , Gd          
Ww          , Ww          , Ww          , Ww          , Ww          , Wwr         , Ww          , Ww          , Ww          , Ww          , Ds          , Dd          , Dd          , Ds          , Ds          , Ds          , Dd          , Gs^Ft       , Gs          , Gs^Ft       , Gs^Ft       , Gs^Ft       , Gs^Ft       , Gs^Ft       , Ds          , Gll^Fp      , Gll^Fp      , Gll^Fmf     , Gll^Fmf     , Gll^Fmf     , Gd          , Gd          , Gll^Fp      , Gll^Fmf     , Hhd^Fdw     , Hhd^Fmf     , Hhd^Fdf     , Gd          , Gd          , Hhd         , Hhd         , Re          , Gd          , Gd          , Gd          , Gd          
Ww          , Ww          , Wo          , Ww          , Ww          , Ww          , Ww          , Ww          , Ww          , Ww          , Ds          , Dd          , Ds          , Dd          , Ds          , Dd          , Ds          , Gs^Ft       , Ds          , Gs^Ft       , Gs          , Gs^Ft       , Gs^Ft       , Gs^Ft       , Gs^Ft       , Gs^Ft       , Gs^Ft       , Gll^Fmf     , Gll^Fmf     , Gs^Fp       , Hh          , Hh          , Hh^Fp       , Hhd^Fmf     , Md          , Md          , Md          , Hhd^Fmf     , Gd          , Gd          , Md          , Re          , Gd          , Gd          , Gll^Fmf     , Gd          
Wo          , Wo          , Wo          , Wo          , Ww          , Ww          , Ww          , Wwr         , Ww          , Ww          , Ww          , Ds          , Ww          , Ds          , Ww          , Ww          , Ww          , Ds          , Ww          , Ds          , Ww          , Ds          , Ds          , Ds          , Gs          , Gs^Ft       , Gll^Fmf     , Ss          , Gs^Fp       , Gll^Fmf     , Hh          , Hh          , Hh          , Md          , Md^Xm       , Md^Xm       , Md          , Hhd^Fmf     , Gs          , Hhd^Fmf     , Hhd^Fmf     , Re          , Gll^Fmf     , Gll^Fp      , Gll^Fp      , Gll^Fp      
Wo          , Wo          , Wo          , Wo          , Wo          , Ww          , Ww          , Ww          , Ww          , Ww          , Ww          , Ww          , Ww          , Ww          , Ww          , Ww          , Ww          , Ww          , Ww          , Ww          , Ww          , Ww          , Ww          , Ds          , Gs^Ft       , Gs^Ft       , Gs^Fp       , Wwt         , Gs          , Gs^Ft       , Gs^Ft       , Gs          , Gs          , Gs^Ft       , Md          , Md^Xm       , Md^Xm       , Md          , Gs          , Gs          , Re          , Re          , Gll^Fmf     , Gll^Fmf     , Ss          , Ss          
Wo          , Wo          , Wo          , Wo          , Wo          , Ww          , Wo          , Ww          , Wo          , Ww          , Ww          , Ww          , Ww          , Ww          , Wo          , Ww          , Ww          , Ww          , Ww          , Ww          , Wwr         , Wwr         , Wwr         , Ds          , Gs^Ft       , Gs^Ft       , Gs^Ft       , Gs^Ft       , Gs          , Gs^Ft       , Gs          , Ss          , Gs^Ft       , Gs^Vht      , Gs^Ft       , Gs          , Gs^Ft       , Gs^Ft       , Hh          , Gs^Ft       , Re          , Gll^Fmf     , Gll^Fmf     , Gll^Fmf     , Gll^Fmf     , Ss          
Wo          , Wo          , Wo          , Wo          , Wo          , Wo          , Wo          , Wo          , Wo          , Ww          , Ww          , Ww          , Ww          , Wo          , Wo          , Ww          , Wo          , Ww          , Ww          , Ww          , Wwr         , Wwr         , Wwr         , Ds          , Gs          , Gs^Vht      , Gs          , Gs^Ft       , Gs^Ft       , Gs          , Gs          , Ds          , Ds          , Gs          , Ss          , Gs^Ft       , Gs^Ft       , Gs^Ft       , Gs^Ft       , Gs          , Re          , Gll^Fmf     , Gll^Fmf     , Gll^Fp      , Gll^Fp      , Ss          
Wo          , Wo          , Wo          , Wo          , Wo          , Wo          , Wo          , Wo          , Wo          , Ww^Vm       , Wo          , Ww          , Wo          , Wo          , Wo          , Wo          , Wo          , Wo          , Ww          , Ww          , Ww          , Wwr         , Wwr         , Ds          , Ds          , Gs          , Gs          , Ds          , Ss          , Ds          , Ds          , Ds          , Ds          , Gs          , Ss          , Ww          , Gs^Ft       , Gs^Ft       , Gs^Ft       , Gs^Ft       , Gs          , Re          , Re          , Gll^Fmf     , Gd          , Gll^Fp      
Wo          , Wo          , Wo          , Wo          , Wo          , Wo          , Wo          , Wo          , Wo          , Wo          , Wo          , Wo          , Wo          , Wo          , Wo          , Wo          , Wo          , Wo          , Ww          , Ww          , Ww^Vm       , Ww          , Wwr         , Wwr         , Ww          , Ds          , Ds          , Ss          , Ss          , Ds          , Ds          , Ds          , Gs          , Ss          , Ww          , Ww          , Ww          , Gs^Ft       , Gs^Ft       , Gs^Ft       , Gd          , Gd          , Re          , Gd          , Gd          , Gd          
Wo          , Wo          , Wo          , Wo          , Wo          , Wo          , Wo          , Wo          , Wo          , Wo          , Wo          , Wo          , Wo          , Wo          , Wo          , Wo          , Wo          , Wo          , Wo          , Ww          , Ww          , Ww          , Ww          , Ww          , Ww          , Ww          , Ds          , Ss          , Ds          , Ds          , Ds          , Ds          , Ww          , Ww          , Ss          , Gs^Ft       , Gs^Ft       , Gs^Ft       , Gs^Ft       , Gs          , Gs^Ft       , Gd          , Gs          , Re          , Gd          , Gd          
Wo          , Wo          , Wo          , Wo          , Wo          , Wo          , Wo          , Wo          , Wo          , Wo          , Ww          , Wo          , Wo          , Wo          , Wo          , Wo          , Wo          , Wo          , Wo          , Wo          , Ww          , Ww          , Ww          , Ww          , Ww          , Ww          , Wwf         , Ww          , Wwf         , Wwf         , Wwf         , Ww          , Ds          , Gs          , Gs          , Ds          , Gs          , Gs^Ft       , Gs^Ft       , Gs^Ft       , Gs          , Gs          , Gs          , Re          , Gd          , Gd          
