border_size=1
usage=map

Xue         , Xue         , Xue         , Xue         , Xue         , Xue         , Xue         , Xue         , Xue         , Xue         , Xue         , Xue         , Xue         , Xue         , Xue         , Xue         , Xue         , Xue         , Xue         , Xue         , Xue         , Xue         , Xue         , Xue         , Xue         , Xue         , Xue         , Xue         , Xue         , Xue         , Xue         , Xue         , Xue         , Xue         
Xue         , Xue         , Xue         , Xue         , Xue         , Xue         , Xue         , Xue         , Xue         , Xue         , Xue         , Xue         , Xue         , Xue         , Xue         , Xue         , Xue         , Xue         , Xue         , Xue         , Xue         , Xue         , Xue         , Xue         , Xue         , Xue         , Xue         , Xue         , Xue         , Xue         , Xue         , Xue         , Xue         , Xue         
Xue         , Xue         , Xue         , Xue         , Xue         , Xue         , Xue         , Xue         , Xue         , Xue         , Xue         , Xue         , Xue         , Xue         , Xue         , Xue         , Xue         , Xue         , Xue         , Xue         , Xue         , Xue         , Xue         , Xue         , Xue         , Xue         , Xue         , Xue         , Xue         , Xue         , Xue         , Xue         , Xue         , Xue         
Xue         , Xue         , Xue         , Xue         , Xue         , Xue         , Xue         , Xue         , Xue         , Xue         , Xue         , Xue         , Xue         , Xue         , Xue         , Xue         , Xue         , Xue         , Xue         , Xue         , Xue         , Xue         , Xue         , Xue         , Xue         , Xue         , Xue         , Xue         , Xue         , Xue         , Xue         , Xue         , Xue         , Xue         
Xue         , Xue         , Xue         , Xue         , Xue         , Xue         , Xue         , Xue         , Xue         , Xue         , Xue         , Xue         , Ql          , Ql          , Ql          , Ql          , Cud         , Ql          , Ql          , Ql          , Ql          , Xue         , Xue         , Xue         , Xue         , Xue         , Xue         , Xue         , Xue         , Xue         , Xue         , Xue         , Xue         , Xue         
Xue         , Xue         , Xue         , Xue         , Xue         , Xue         , Xue         , Xue         , Xue         , Xue         , Qxe         , Ql          , Uue^Es      , Cud         , Cud         , Qlf         , Qlf         , Qlf         , Cud         , Cud         , Uue^Es      , Qxe         , Qxe         , Xue         , Xue         , Xue         , Xue         , Xue         , Xue         , Xue         , Xue         , Xue         , Xue         , Xue         
Xue         , Xue         , Xue         , Xue         , Xue         , Xue         , Xue         , Xue         , Xue         , Xue         , Qxe         , Qxe         , Qxu^Bs|     , Ql          , Ql          , Cud         , 2 Kud       , Cud         , Ql          , Ql          , Qxu^Bs|     , Qxe         , Qxe         , Xue         , Xue         , Xue         , Xue         , Xue         , Xue         , Xue         , Qlf         , Xue         , Xue         , Xue         
Xue         , Xue         , Xue         , Xue         , Xue         , Xue         , Xue         , Xue         , Xue         , Ql          , Qxe         , Qxe         , Uu^Vu       , Qxe         , Ql          , Cud         , Cud         , Cud         , Ql          , Qxe         , Uu^Vu       , Qxe         , Qxe         , Ql          , Xue         , Xue         , Xue         , Xue         , Xue         , Qlf         , Ql          , Qlf         , Xue         , Xue         
Xue         , Xue         , Xue         , Xue         , Xue         , Xue         , Xue         , Xue         , Xue         , Ql          , Qxe         , Uu^Vu       , Uu^Vu       , Qxe         , Qxu^Bs/     , Ql          , Qxu^Bs|     , Ql          , Qxu^Bs\     , Qxe         , Uu^Vu       , Uu^Vu       , Qxe         , Qxe         , Xue         , Xue         , Xue         , Xue         , Xue         , Qlf         , Qlf         , Qlf         , Xue         , Xue         
Xue         , Xue         , Xue         , Xue         , Xue         , Xue         , Qlf         , Xue         , Xue         , Qxe         , Qxe         , Ql          , Qlf         , Ql          , Ql          , Qxe         , Uu^Vu       , Qxe         , Ql          , Ql          , Qlf         , Ql          , Qxe         , Qxe         , Xue         , Xue         , Xue         , Xue         , Xue         , Xue         , Qlf         , Xue         , Xue         , Xue         
Xue         , Xue         , Xue         , Xue         , Xue         , Xue         , Qlf         , Xue         , Xue         , Xue         , Qxe         , Ql          , Ql          , Qlf         , Ql          , Qxe         , Qxu^Bs|     , Qxe         , Ql          , Qlf         , Ql          , Ql          , Qxe         , Xue         , Xue         , Xue         , Xue         , Xue         , Xue         , Xue         , Uu^Vu       , Xue         , Xue         , Xue         
Xue         , Xue         , Xue         , Xue         , Ql          , Ql          , Xue         , Xue         , Xue         , Xue         , Xue         , Qxe         , Qxe         , Ql          , Qxe         , Qxe         , Qxu^Bs|     , Qxe         , Qxe         , Ql          , Qxe         , Qxe         , Xue         , Xue         , Xue         , Xue         , Xue         , Xue         , Xue         , Xue         , Cud         , Uue         , Uu^Vu       , Xue         
Xue         , Xue         , Xue         , Ql          , Xue         , Xue         , Xue         , Xue         , Xue         , Xue         , Xue         , Xue         , Xue         , Qxe         , Qxe         , Qxe         , Rb^Ii       , Qxe         , Qxe         , Qxe         , Xue         , Xue         , Xue         , Xue         , Xue         , Xue         , Xue         , Xue         , Xue         , Cud         , 5 Kud       , Cud         , Uh          , Xue         
Xue         , Xue         , Xue         , Ql          , Uu^Vu       , Cud         , Cud         , Xue         , Rb          , Xue         , Xue         , Xue         , Xue         , Xue         , Xue         , Rb^Ii       , Rb^Ii       , Rb^Ii       , Xue         , Xue         , Xue         , Xue         , Xue         , Xue         , Xue         , Xue         , Xue         , Xue         , Xue         , Cud         , Cud         , Cud         , Uue         , Xue         
Xue         , Xue         , Cud         , Cud         , Cud         , 6 Kud       , Rb          , Uue         , Uh          , Xue         , Xue         , Xue         , Xue         , Xue         , Xue         , Uue^Ii      , Rb^Ii       , Rb^Ii       , Xue         , Xue         , Xue         , Xue         , Xue         , Xue         , Xue         , Xue         , Xue         , Xue         , Rb          , Uu^Vu       , Rb          , Ql          , Xue         , Xue         
Xue         , Xue         , Xue         , Cud         , Rb          , Rb          , Uue         , Rb          , Rb          , Uu^Vu       , Xue         , Xue         , Xue         , Xue         , Xue         , Rb^Es       , Rb^Es       , Rb^Es       , Xue         , Xue         , Xue         , Xue         , Xue         , Xue         , Uue         , Xue         , Rb          , Rb          , Rb          , Uue         , Rb          , Uue         , Xue         , Xue         
Xue         , Xue         , Rb          , Uue         , Ql          , Uue         , Rb          , Rb          , Xue         , Uue         , Uue         , Xue         , Xue         , Xue         , Xue         , Rb^Es       , Rb^Es       , Uue^Es      , Xue         , Xue         , Uue^Es      , Xue         , Rb          , Rb          , Rb          , Rb          , Xue         , Rb          , Uue         , Xue         , Rb          , Uu^Vu       , Xue         , Xue         
Xue         , Xue         , Uue^Es      , Uu^Vu       , Uh          , Ql          , Rb          , Uue         , Xue         , Xue         , Rb          , Uue         , Rb          , Xuce        , Rb          , Rb^Es       , Rb          , Rb^Es       , Uue^Es      , Xuce        , Uu^Vu       , Rb          , Uue         , Rb          , Uue         , Xue         , Xue         , Uu^Vu       , Rb          , Rb          , Uue         , Xue         , Xue         , Xue         
Xue         , Xue         , Xue         , Rb          , Uue         , Rb          , Xue         , Uu^Vu       , Xue         , Xue         , Rb          , Uu^Vu       , Rb          , Xuce        , Uue^Es      , Uue^Es      , Ql          , Uue^Es      , Uue^Es      , Xuce        , Rb          , Rb          , Xue         , Rb          , Rb          , Xue         , Rb          , Rb          , Xue         , Rb          , Xue         , Xue         , Xue         , Xue         
Xue         , Ql          , Uue         , Xue         , Uue         , Rb          , Uue         , Xue         , Rb          , Uue         , Rb          , Uue         , Xue         , Xuce        , Xue         , Uue^Es      , Rb          , Uue^Es      , Xue         , Xue         , Xue         , Rb          , Rb          , Rb          , Rb          , Uu^Vu       , Rb          , Xue         , Ql          , Uue         , Xue         , Xue         , Xue         , Xue         
Xue         , Xue         , Rb          , Uue         , Rb          , Uue         , Rb          , Rb          , Xue         , Xue         , Rb          , Xue         , Xue         , Xue         , Rb          , Rb          , Uue^Es      , Rb          , Xue         , Uu^Vu       , Rb          , Xue         , Xue         , Uue         , Xue         , Rb          , Uue         , Xue         , Uue         , Xue         , Xue         , Xue         , Xue         , Xue         
Xue         , Xue         , Uu^Vu       , Xue         , Xue         , Xue         , Rb          , Uue^Es      , Xue         , Rb          , Xue         , Xue         , Xue         , Rb          , Rb          , Rb          , Rb          , Rb          , Rb          , Xue         , Ql          , Rb          , Rb          , Xue         , Ql          , Xue         , Xue         , Rb          , Xue         , Xue         , Xue         , Xue         , Xue         , Xue         
Uu^Ii       , Xue         , Xue         , Uue         , Rb          , Uue         , Uue         , Uue         , Uu^Vu       , Uue         , Xue         , Xue         , Rb          , Rb          , Rb          , Ql          , Rb          , Uue         , Rb          , Uue         , Uue         , Ql          , Uue         , Rb          , Uue         , Xue         , Uue         , Xue         , Xue         , Xue         , Xue         , Xue         , Xue         , Xue         
Rb          , Uu^Ii       , Uu^Ii       , Xue         , Xue         , Xue         , Xue         , Xue         , Xue         , Uue         , Ql          , Xue         , Xue         , Rb          , Uue         , Rb          , Xue         , Uu^Vu       , Xue         , Uue         , Xue         , Rb          , Rb          , Rb          , Rb          , Rb          , Rb          , Rb          , Xue         , Xue         , Xue         , Xue         , Xue         , Xue         
Uu^Ii       , Rb^Ii       , Uu          , Xue         , Xue         , Xue         , Xue         , Xue         , Xue         , Xue         , Xue         , Xue         , Xue         , Xue         , Xue         , Xue         , Xue         , Xue         , Xue         , Xue         , Xue         , Xue         , Xue         , Uue         , Rb          , Rb          , Rb          , Uu^Vu       , Xue         , Xue         , Xue         , Xue         , Xue         , Xue         
Uu^Ii       , Rb          , Rb          , Cud         , Cud         , Uue         , Uue^Emf     , Xue         , Uue^Dr      , Ql          , Uue         , Xue         , Xue         , Xue         , Xue         , Ql          , Ql          , Uue         , Uue         , Rb          , Rb          , Xue         , Xue         , Xue         , Ql          , Uue         , Xue         , Rb          , Rb          , Xue         , Xue         , Xue         , Xue         , Xue         
Xue         , Uu          , Cud         , 1 Kud       , Cud         , Rb^Es       , Uue^Dr      , Rb^Es       , Rb^Es       , Rb^Es       , Uu^Vu       , Rb          , Rb          , Uue         , Rb          , Ql          , Ql          , Rb          , Uue         , Uue^Es      , Rb          , Xue         , Xue         , Xue         , Ql          , Ql          , Rb          , Rb          , Xue         , Xue         , Xue         , Xue         , Qlf         , Xue         
Xue         , Rb          , Cud         , Cud         , Uue^Es      , Uue^Es      , Uue^Dr      , Uue^Dr      , Uue^Es      , Uue^Es      , Uue         , Rb          , Uue         , Rb          , Rb          , Xue         , Xue         , Uue         , Uu^Vu       , Xue         , Cud         , Xue         , Xue         , Xue         , Uue         , Rb          , Uu^Vu       , Rb          , Xue         , Xue         , Xue         , Ql          , Xue         , Xue         
Xue         , Xue         , Xue         , Uue         , Xue         , Rb^Es       , Xue         , Uue^Emf     , Xue         , Xue         , Xue         , Rb          , Rb          , Rb          , Rb          , Xue         , Xue         , Uu^Vu       , Xue         , Xue         , Cud         , Xue         , Uu^Vu       , Rb          , Rb          , Rb          , Rb          , Xue         , Xue         , Xue         , Ql          , Ql          , Xue         , Xue         
Xue         , Xue         , Xue         , Xue         , Uue         , Ql          , Uue         , Xue         , Xue         , Xue         , Xue         , Rb          , Rb          , Ql          , Uue         , Xue         , Xue         , Xue         , Xue         , 3 Kud       , Xue         , Xue         , Rb          , Rb          , Uue         , Rb          , Xue         , Xue         , Xue         , Xue         , Ql          , Xue         , Xue         , Xue         
Xue         , Xue         , Xue         , Xue         , Uue         , Rb          , Rb          , Xue         , Xue         , Xue         , Xue         , Xue         , Uue         , Rb          , Rb          , Uue         , Xue         , Xue         , Xue         , Xue         , Ql          , Ql          , Rb          , Rb          , Xue         , Xue         , Xue         , Xue         , Xue         , Xue         , Uue         , Ql          , Xue         , Xue         
Xue         , Xue         , Xue         , Xue         , Xue         , Uue         , Rb          , Uue         , Xue         , Xue         , Xue         , Xue         , Xue         , Uue         , Rb          , Rb          , Uue         , Rb          , Rb          , Uue         , Uue         , Rb          , Uue         , Rb          , Xue         , 4 Kud       , Cud         , Xue         , Ql          , Ql          , Ql          , Ql          , Xue         , Xue         
Xue         , Xue         , Xue         , Xue         , Xue         , Ql          , Rb          , Rb          , Xue         , Xue         , Xue         , Xue         , Xue         , Ql          , Ql          , Rb          , Rb          , Rb          , Uue         , Rb          , Xue         , Rb          , Xue         , Xue         , Rb          , Cud         , Rb          , Rb          , Xue         , Xue         , Xue         , Xue         , Xue         , Xue         
Xue         , Xue         , Xue         , Xue         , Xue         , Xue         , Xue         , Rb          , Uue         , Xue         , Xue         , Xue         , Xue         , Xue         , Xue         , Xue         , Xue         , Xue         , Xue         , Xue         , Xue         , Xue         , Ql          , Xue         , Rb          , Rb          , Ql          , Rb          , Uu^Vu       , Xue         , Xue         , Xue         , Xue         , Xue         
Xue         , Xue         , Xue         , Xue         , Xue         , Xue         , Xue         , Rb          , Rb          , Rb          , Xue         , Xue         , Xue         , Xue         , Xue         , Xue         , Xue         , Qlf         , Xue         , Xue         , Rb          , Xue         , Rb          , Rb          , Uue         , Ql          , Ql          , Uue         , Rb          , Xue         , Xue         , Xue         , Xue         , Xue         
Xue         , Xue         , Xue         , Xue         , Xue         , Xue         , Xue         , Xue         , Xue         , Rb          , Rb          , Ql          , Ql          , Ql          , Uu^Vu       , Uue         , Uue         , Uu^Vu       , Ql          , Rb          , Uue         , Rb          , Uue         , Rb          , Uue         , Uue         , Uue         , Rb          , Uue^Em      , Xue         , Xue         , Xue         , Xue         , Xue         
Xue         , Xue         , Xue         , Xue         , Xue         , Xue         , Xue         , Xue         , Xue         , Xue         , Xue         , Xue         , Xue         , Xue         , Xue         , Xue         , Xue         , Xue         , Xue         , Xue         , Xue         , Xue         , Xue         , Xue         , Xue         , Xue         , Xue         , Xue         , Xue         , Xue         , Xue         , Xue         , Xue         , Xue         
Xue         , Xue         , Xue         , Xue         , Xue         , Xue         , Xue         , Xue         , Xue         , Xue         , Xue         , Xue         , Xue         , Xue         , Xue         , Xue         , Xue         , Xue         , Xue         , Xue         , Xue         , Xue         , Xue         , Xue         , Xue         , Xue         , Xue         , Xue         , Xue         , Xue         , Xue         , Xue         , Xue         , Xue         
